76
15
15 0 0 0  0 0 0 0 0 0 0 0 0 0  0 0 0 0 0 0 0 0 0 0 0 0  0 0 0 0 0 0 0 0 0 0 0 0  0  0 0  0 0 0 0 0 0 0 0 0 0 0 0 0 0  0  0  0 0 0 0  0  0 0 0 0 0 0 0 0 0 0 0 0 0 0
15 0 0 0  0 0 0 0 0 0 0 0 0 0  0 0 0 0 0 0 0 0 0 0 0 0  0 0 0 0 0 0 0 0 0 0 0 0  0  0 0  0 0 0 0 0 0 0 0 0 0 0 0 0 0  0  0  0 0 0 0  0  0 0 0 0 0 0 0 0 0 0 0 0 0 0
15 0 0 0  0 0 0 0 0 0 0 0 0 0  0 0 0 0 0 0 0 0 0 0 0 0  0 0 0 0 0 0 0 0 0 0 0 0  0  0 0  0 0 0 0 0 0 0 0 0 0 0 0 0 0  0  0  0 0 0 0  0  0 0 0 0 0 0 0 0 0 0 0 0 0 0
15 0 0 0  0 0 0 0 0 0 0 0 0 0  0 0 0 0 0 0 0 0 0 0 0 0  0 0 0 0 0 0 0 0 0 0 0 0  0  0 0  0 0 0 0 0 0 0 0 0 0 0 0 0 0  0  0  0 0 0 0  0  0 0 0 0 0 0 0 0 0 0 0 0 0 0
15 0 0 0  0 0 0 0 0 0 0 0 0 0  0 0 0 0 0 0 0 0 0 0 0 0  0 0 0 0 0 0 0 0 0 0 0 0  0  0 0  0 0 0 0 0 0 0 0 0 0 0 0 0 0  0  14 9 9 9 11 0  0 0 0 0 0 0 0 0 0 0 0 0 0 0
15 0 0 0  0 0 0 0 0 0 0 0 0 0  0 0 0 0 0 0 0 0 0 0 0 0  0 0 0 0 0 0 0 0 0 0 0 0  0  0 0  0 0 0 0 0 0 0 0 0 0 0 0 0 0  0  15 4 4 4 15 0  0 0 0 0 0 0 0 0 0 0 0 0 0 0
15 0 0 0  0 0 0 0 0 0 0 0 0 0  0 0 0 0 0 0 0 0 0 0 0 0  0 0 0 0 0 0 0 0 0 0 0 0  0  0 0  0 0 0 0 0 0 0 0 0 0 0 0 0 0  14 15 4 4 4 15 0  0 0 0 0 0 0 0 0 0 0 0 0 0 0
15 0 0 0  0 0 0 0 0 0 0 0 0 0  0 0 0 0 0 0 0 0 0 0 0 0  0 0 0 0 0 0 0 0 0 0 0 0  0  0 0  0 0 0 0 0 0 0 0 0 0 0 0 0 0  15 4  4 4 4 15 0  0 0 0 0 0 0 0 0 0 0 0 0 0 0
15 0 0 0  0 0 0 0 0 0 0 0 0 0  0 0 0 0 0 0 0 0 0 0 0 0  0 0 0 0 0 0 0 0 0 0 0 0  0  0 0  0 0 0 0 0 0 0 0 0 0 0 0 0 14 15 4  4 4 4 15 11 0 0 0 0 0 0 0 0 0 0 0 0 0 0
15 0 0 0  0 0 0 0 0 0 0 0 0 0  0 0 0 0 0 0 0 0 0 0 0 0  0 0 0 0 0 0 0 0 0 0 0 0  14 9 11 0 0 0 0 0 0 0 0 0 0 0 0 0 15 4  4  4 4 4 4  15 0 0 0 0 0 0 0 0 0 0 0 0 0 0
15 0 0 0  0 0 0 0 0 0 0 0 0 0  0 0 0 0 0 0 0 0 0 0 0 0  0 0 0 0 0 0 0 0 0 0 0 0  15 4 15 0 0 0 0 0 0 0 0 0 0 0 0 0 15 4  4  4 4 4 4  15 0 0 0 0 0 0 0 0 0 0 0 0 0 0
15 0 0 0  0 0 0 0 0 0 0 0 0 0  0 0 0 0 0 0 0 0 0 0 0 0  0 0 0 0 0 0 0 0 0 0 0 0  15 4 15 0 0 0 0 0 0 0 0 0 0 0 0 0 15 4  4  4 4 4 4  15 0 0 0 0 0 0 0 0 0 0 0 0 0 0
9  8 9 12 9 9 9 9 9 9 8 9 9 12 9 9 9 9 9 9 9 9 8 9 9 12 9 9 8 9 8 9 9 9 9 9 9 12 9  8 9  9 9 9 9 8 9 8 9 9 9 9 8 9 9  9  9  8 9 9 9  9 9 9 9 9 9 9 8 9 8 9 9 9 9 8
1  1 1 3  1 1 1 1 1 1 1 1 1 3  1 1 1 1 1 1 1 1 1 1 1 3  1 1 1 1 1 1 1 1 1 1 1 3  1  1 1  1 1 1 1 1 1 1 1 1 1 1 1 1 1  1  1  1 1 1 1  1 1 1 1 1 1 1 1 1 1 1 1 1 1 1
4  4 4 4  4 4 4 4 4 4 4 4 4 4  4 4 4 4 4 4 4 4 4 4 4 4  4 4 4 4 4 4 4 4 4 4 4 4  4  4 4  4 4 4 4 4 4 4 4 4 4 4 4 4 4  4  4  4 4 4 4  4 4 4 4 4 4 4 4 4 4 4 4 4 4 4